*************************
*                       *
*                       *
*                       *
*                       *
*  #######              *
*                       *
*                       *
*                       *
*       ###########     *
*                       *
*                       *
*                       *
*      ###     #######  *
*                       *
*                       *
*  ##########           *
*                       *
*                       *
*          ***          *
*          * *          *
*************************
